爱 - ài - love
爱好 - àihào - hobby, interest
八 - bā - eight
爸爸 - bàba - father, dad
爸 - bà - father, dad
吧 - ba - (particle indicating suggestion or uncertainty)
白 - bái - white
白天 - báitiān - daytime, day
百 - bǎi - hundred
班 - bān - class, shift, team

半 - bàn - half
半年 - bànnián - half year, six months
半天 - bàntiān - half day, long time
帮 - bāng - help, assist
帮忙 - bāngmáng - help, lend a hand
包 - bāo - bag, package, wrap
包子 - bāozi - steamed bun, dumpling
杯 - bēi - cup, glass
杯子 - bēizi - cup, glass
北 - běi - north

北边 - běibiān - north side, northern area
北京 - Běijīng - Beijing
本 - běn - measure word for books, this, current
本子 - běnzi - notebook, book
比 - bǐ - compare, than
别 - bié - don't, other, different
别的 - biéde - other, else
别人 - biérén - other people, others
病 - bìng - illness, disease, sick
病人 - bìngrén - patient, sick person

不大 - bù dà - not big, not very
不对 - bùduì - incorrect, wrong
不客气 - bù kèqì - you're welcome, don't be polite
不用 - bùyòng - don't need to, no need
不 - bù - not, no
菜 - cài - vegetable, dish, cuisine
茶 - chá - tea
差 - chà - poor, bad, difference
常 - cháng - often, frequently
常常 - chángcháng - often, frequently

唱 - chàng - sing
唱歌 - chànggē - sing a song
车 - chē - car, vehicle
车票 - chēpiào - ticket, bus ticket
车上 - chē shang - on the car/bus
车站 - chēzhàn - bus stop, station
吃 - chī - eat
吃饭 - chīfàn - eat a meal, have a meal
出 - chū - go out, come out
出来 - chūlái - come out, emerge

出去 - chūqù - go out, leave
穿 - chuān - wear, put on
床 - chuáng - bed
次 - cì - time, occasion, measure word for actions
从 - cóng - from, since
错 - cuò - wrong, mistake
打 - dǎ - hit, strike, play
打车 - dǎchē - take a taxi
打电话 - dǎ diànhuà - make a phone call
打开 - dǎkāi - open

打球 - dǎ qiú - play ball, play sports
大 - dà - big, large
大学 - dàxué - university, college
大学生 - dàxuéshēng - university student, college student
到 - dào - arrive, reach, to
得到 - dédào - get, obtain, receive
地 - de - (particle used after adverbs)
的 - de - (possessive particle), of
等 - děng - wait, etc., and so on
地 - dì - ground, earth, place

地点 - dìdiǎn - location, place
地方 - dìfang - place, area, location
地上 - dìshang - on the ground, floor
地图 - dìtú - map
弟弟 - dìdi - younger brother
弟 - dì - younger brother
第 - dì - (ordinal prefix)
第二 - dì-èr - second
点 - diǎn - point, dot, o'clock
电 - diàn - electricity, electric

电话 - diànhuà - telephone, phone
电脑 - diànnǎo - computer
电视 - diànshì - television, TV
电视机 - diànshìjī - television set, TV set
电影 - diànyǐng - movie, film
电影院 - diànyǐngyuàn - movie theater, cinema
东 - dōng - east
东边 - dōngbian - east side, eastern area
东西 - dōngxi - thing, stuff, east and west
动 - dòng - move, move about

动作 - dòngzuò - action, movement
都 - dōu - all, both, already
读 - dú - read, study
读书 - dúshū - read books, study
对 - duì - correct, right, to
对不起 - duìbuqǐ - sorry, excuse me
多 - duō - many, much, more
多少 - duōshao - how much, how many
饿 - è - hungry
儿子 - érzi - son

二 - èr - two
饭 - fàn - rice, meal, food
饭店 - fàndiàn - restaurant, hotel
房间 - fángjiān - room
房子 - fángzi - house, building
放 - fàng - put, place, let go
放假 - fàngjià - have a holiday, take a vacation
放学 - fàngxué - finish school, school is over
飞 - fēi - fly
飞机 - fēijī - airplane, aircraft

非常 - fēicháng - very, extremely
分 - fēn - minute, divide, separate
风 - fēng - wind
干 - gān - dry, do, work
干净 - gānjìng - clean, neat
干 - gàn - do, work, trunk
干什么 - gàn shénme - what are you doing, what for
高 - gāo - high, tall
高兴 - gāoxìng - happy, glad
告诉 - gàosu - tell, inform

哥哥 - gēge - older brother
哥 - gē - older brother
歌 - gē - song
个 - gè - measure word for people and objects
给 - gěi - give, for, to
跟 - gēn - follow, with, and
工人 - gōngrén - worker, laborer
工作 - gōngzuò - work, job
关 - guān - close, shut, concern
关上 - guānshang - close, shut

贵 - guì - expensive, precious
国 - guó - country, nation
国家 - guójiā - country, nation, state
国外 - guówài - foreign country, abroad
过 - guò - pass, cross, over
还 - hái - still, yet, also
还是 - háishì - still, nevertheless, or
还有 - háiyǒu - also have, moreover
孩子 - háizi - child, kid
汉语 - Hànyǔ - Chinese language

汉字 - Hànzì - Chinese character
好 - hǎo - good, well, nice
好吃 - hǎochī - delicious, tasty
好看 - hǎokàn - good-looking, beautiful
好听 - hǎotīng - pleasant to hear, nice-sounding
好玩儿 - hǎowánr - fun, interesting
号 - hào - number, day of month
喝 - hē - drink
和 - hé - and, with, peaceful
很 - hěn - very, quite
后 - hòu - after, behind, back
后边 - hòubian - behind, back, rear
后天 - hòutiān - day after tomorrow
花 - huā - flower, spend
话 - huà - word, speech, talk
坏 - huài - bad, broken, spoiled
还 - huán - return, give back
回 - huí - return, go back
回答 - huídá - answer, reply
回到 - huídào - return to, go back to

回家 - huíjiā - go home, return home
回来 - huílái - come back, return
回去 - huíqù - go back, return
会 - huì - can, will, meeting
火车 - huǒchē - train
机场 - jīchǎng - airport
机票 - jīpiào - plane ticket
鸡蛋 - jīdàn - egg
几 - jǐ - how many, several
记 - jì - remember, record
记得 - jìde - remember
记住 - jìzhù - remember, memorize
家 - jiā - home, family
家里 - jiālǐ - at home, home
家人 - jiārén - family member
间 - jiān - measure word for rooms
见 - jiàn - see, meet
见面 - jiànmiàn - meet, see each other
教 - jiāo - teach
叫 - jiào - call, be called

教学楼 - jiàoxuélóu - teaching building, classroom building
姐姐 - jiějie - older sister
姐 - jiě - older sister
介绍 - jièshào - introduce, introduction
今年 - jīnnián - this year
今天 - jīntiān - today
进 - jìn - enter, go in
进来 - jìnlái - come in, enter
进去 - jìnqù - go in, enter
九 - jiǔ - nine
就 - jiù - just, only, then
觉得 - juéde - feel, think
开 - kāi - open, drive, start
开车 - kāichē - drive a car
开会 - kāihuì - have a meeting
开玩笑 - kāi wánxiào - joke, make fun of
看 - kàn - look, see, watch
看病 - kànbìng - see a doctor
看到 - kàndào - see, catch sight of
看见 - kànjiàn - see, catch sight of

考 - kǎo - test, examine
考试 - kǎoshì - exam, test
渴 - kě - thirsty
课 - kè - lesson, class
课本 - kèběn - textbook
课文 - kèwén - lesson text
口 - kǒu - mouth, opening
块 - kuài - piece, block, yuan (currency)
快 - kuài - fast, quick
来 - lái - come, arrive
来到 - láidào - arrive at, reach
老 - lǎo - old, aged
老人 - lǎorén - old person, elderly
老师 - lǎoshī - teacher
了 - le - (particle indicating completed action)
累 - lèi - tired, exhausted
冷 - lěng - cold
里 - lǐ - inside, in, within
里 - lǐ - inside, in, within
里边 - lǐbian - inside, within

两 - liǎng - two, both
零 - líng - zero
〇 - líng - zero
六 - liù - six
楼 - lóu - building, floor
楼上 - lóushang - upstairs
楼下 - lóuxià - downstairs
路 - lù - road, path, way
路口 - lùkǒu - intersection, crossroads
路上 - lùshang - on the road, on the way
妈妈 - māma - mother, mom
妈 - mā - mother, mom
马路 - mǎlù - road, street
马上 - mǎshàng - immediately, right away
吗 - ma - (question particle)
买 - mǎi - buy, purchase
慢 - màn - slow
忙 - máng - busy
毛 - máo - hair, fur, mao (currency unit)
没 - méi - not have, there isn't

没关系 - méi guānxi - it doesn't matter, never mind
没什么 - méi shénme - nothing much, it's nothing
没事儿 - méi shìr - it's nothing, no problem
没有 - méiyǒu - not have, there isn't
妹妹 - mèimei - younger sister
妹 - mèi - younger sister
门 - mén - door, gate
门口 - ménkǒu - doorway, entrance
门票 - ménpiào - entrance ticket
们 - men - (plural suffix for pronouns)
朋友们 - péngyoumen - friends
米饭 - mǐfàn - rice
面包 - miànbāo - bread
面条儿 - miàntiáor - noodles
名字 - míngzi - name
明白 - míngbai - understand, clear
明年 - míngnián - next year
明天 - míngtiān - tomorrow
拿 - ná - take, hold, bring
哪 - nǎ - which, where

哪里 - nǎlǐ - where
哪里 - nǎlǐ - where
哪儿 - nǎr - where
哪些 - nǎxiē - which ones, what
那 - nà - that, those
那边 - nàbian - over there, that side
那里 - nàlǐ - there, that place
那里 - nàlǐ - there, that place
那儿 - nàr - there, that place
那些 - nàxiē - those, those ones
奶 - nǎi - milk, breast
奶奶 - nǎinai - grandmother, grandma
男 - nán - male, man
男孩儿 - nánháir - boy
男朋友 - nánpéngyou - boyfriend
男人 - nánrén - man, male
男生 - nánshēng - male student, boy student
南 - nán - south
南边 - nánbian - south side, southern area
难 - nán - difficult, hard

呢 - ne - (particle indicating question or continuation)
能 - néng - can, be able to
你 - nǐ - you
你们 - nǐmen - you (plural)
年 - nián - year
您 - nín - you (polite form)
牛奶 - niúnǎi - milk
女 - nǚ - female, woman
女儿 - nǚ'ér - daughter
女孩儿 - nǚháir - girl
女朋友 - nǚpéngyou - girlfriend
女人 - nǚrén - woman, female
女生 - nǚshēng - female student, girl student
旁边 - pángbiān - beside, next to
跑 - pǎo - run, escape
朋友 - péngyou - friend
票 - piào - ticket
七 - qī - seven
起 - qǐ - rise, start, begin
起床 - qǐchuáng - get up, wake up

起来 - qǐlái - get up, rise
起来 - qǐlái - get up, rise
汽车 - qìchē - car, automobile
前 - qián - front, before, ago
前边 - qiánbian - front, in front
前天 - qiántiān - day before yesterday
钱 - qián - money
钱包 - qiánbāo - wallet, purse
请 - qǐng - please, invite
请假 - qǐngjià - ask for leave
请进 - qǐngjìn - please come in
请问 - qǐngwèn - excuse me, may I ask
请坐 - qǐngzuò - please sit down
球 - qiú - ball, sphere
去 - qù - go, leave
去年 - qùnián - last year
热 - rè - hot, warm
人 - rén - person, human
认识 - rènshi - know, recognize
认真 - rènzhēn - serious, earnest

日 - rì - day, sun
日期 - rìqī - date
肉 - ròu - meat, flesh
三 - sān - three
山 - shān - mountain, hill
商场 - shāngchǎng - shopping mall, market
商店 - shāngdiàn - shop, store
上 - shàng - up, above, on
上班 - shàngbān - go to work
上边 - shàngbian - above, upper part
上车 - shàngchē - get on (vehicle)
上次 - shàngcì - last time
上课 - shàngkè - attend class, have class
上网 - shàngwǎng - go online, surf the internet
上午 - shàngwǔ - morning, a.m.
上学 - shàngxué - go to school
少 - shǎo - few, little, less
谁 - shéi - who
谁 - shéi - who
身上 - shēnshang - on the body, with oneself

身体 - shēntǐ - body, health
什么 - shénme - what
生病 - shēngbìng - get sick, fall ill
生气 - shēngqì - get angry, be angry
生日 - shēngrì - birthday
十 - shí - ten
时候 - shíhou - time, moment
时间 - shíjiān - time, period
事 - shì - matter, affair, thing
试 - shì - try, test
是 - shì - be, is, are
是不是 - shì bù shì - is it or isn't it
手 - shǒu - hand
手机 - shǒujī - mobile phone, cell phone
书 - shū - book
书包 - shūbāo - schoolbag, backpack
书店 - shūdiàn - bookstore
树 - shù - tree
水 - shuǐ - water
水果 - shuǐguǒ - fruit

睡 - shuì - sleep
睡觉 - shuìjiào - sleep, go to bed
说 - shuō - say, speak, talk
说话 - shuōhuà - speak, talk
四 - sì - four
送 - sòng - send, give, deliver
岁 - suì - year (of age)
他 - tā - he, him
他们 - tāmen - they, them (male)
她 - tā - she, her
她们 - tāmen - they, them (female)
太 - tài - too, very, extremely
天 - tiān - day, sky, heaven
天气 - tiānqì - weather
听 - tīng - listen, hear
听到 - tīngdào - hear, catch
听见 - tīngjiàn - hear, catch
听写 - tīngxiě - dictation
同学 - tóngxué - classmate, schoolmate
图书馆 - túshūguǎn - library

外 - wài - outside, foreign
外边 - wàibian - outside, exterior
外国 - wàiguó - foreign country
外语 - wàiyǔ - foreign language
玩儿 - wánr - play, have fun
晚 - wǎn - evening, late
晚饭 - wǎnfàn - dinner, evening meal
晚上 - wǎnshang - evening, night
网上 - wǎngshang - online, on the internet
网友 - wǎngyǒu - online friend, netizen
忘 - wàng - forget
忘记 - wàngjì - forget
问 - wèn - ask, question
我 - wǒ - I, me
我们 - wǒmen - we, us
五 - wǔ - five
午饭 - wǔfàn - lunch
西 - xī - west
西边 - xībian - west side, western area
洗 - xǐ - wash, clean

洗手间 - xǐshǒujiān - bathroom, restroom
喜欢 - xǐhuan - like, love
下 - xià - down, below, next
下班 - xiàbān - get off work
下边 - xiàbian - below, under
下车 - xiàchē - get off (vehicle)
下次 - xiàcì - next time
下课 - xiàkè - finish class, class is over
下午 - xiàwǔ - afternoon, p.m.
下雨 - xiàyǔ - rain
先 - xiān - first, before
先生 - xiānsheng - Mr., sir, gentleman
现在 - xiànzài - now, currently
想 - xiǎng - think, want, miss
小 - xiǎo - small, little
小孩儿 - xiǎoháir - child, kid
小姐 - xiǎojiě - Miss, young lady
小朋友 - xiǎopéngyou - child, little friend
小时 - xiǎoshí - hour
小学 - xiǎoxué - primary school, elementary school

小学生 - xiǎoxuéshēng - primary school student, elementary school student
笑 - xiào - laugh, smile
写 - xiě - write
谢谢 - xièxie - thank you, thanks
新 - xīn - new, fresh
新年 - xīnnián - New Year
星期 - xīngqī - week
星期日 - xīngqīrì - Sunday
星期天 - xīngqītiān - Sunday
行 - xíng - okay, all right, walk
休息 - xiūxi - rest, take a break
学 - xué - study, learn
学生 - xuésheng - student
学习 - xuéxí - study, learn
学校 - xuéxiào - school
学院 - xuéyuàn - college, institute
要 - yào - want, need, will
爷爷 - yéye - grandfather, grandpa
也 - yě - also, too, as well
页 - yè - page

一 - yī - one
衣服 - yīfu - clothes, clothing
医生 - yīshēng - doctor, physician
医院 - yīyuàn - hospital
一半 - yībàn - half
一会儿 - yīhuìr - a while, a moment
一块儿 - yīkuàir - together
一下儿 - yīxiàr - once, a bit
一样 - yīyàng - same, alike
一边 - yībiān - one side, while
一点儿 - yīdiǎnr - a little, a bit
一起 - yīqǐ - together
一些 - yīxiē - some, a few
用 - yòng - use, with
有 - yǒu - have, there is
有的 - yǒude - some, some people
有名 - yǒumíng - famous, well-known
有时候 - yǒushíhou - sometimes
有时 - yǒushí - sometimes
有些 - yǒuxiē - some, somewhat
有一些 - yǒuyīxiē - have some, there are some
有用 - yǒuyòng - useful, helpful
右 - yòu - right
右边 - yòubian - right side
雨 - yǔ - rain
元 - yuán - yuan (currency)
远 - yuǎn - far, distant
月 - yuè - month, moon
再 - zài - again, once more
再见 - zàijiàn - goodbye, see you
在 - zài - at, in, on
在家 - zàijiā - at home
早 - zǎo - early, morning
早饭 - zǎofàn - breakfast
早上 - zǎoshang - morning
怎么 - zěnme - how, what
站 - zhàn - stand, station
找 - zhǎo - look for, find
找到 - zhǎodào - find, locate
这 - zhè - this, these
这边 - zhèbian - this side, here
这里 - zhèlǐ - here, this place
这儿 - zhèr - here, this place
这些 - zhèxiē - these, these ones
着 - zhe - (particle indicating ongoing action)
真 - zhēn - real, true, really
真的 - zhēnde - really, truly
正 - zhèng - just, exactly, correct
正在 - zhèngzài - in the process of, currently
知道 - zhīdào - know, understand
知识 - zhīshi - knowledge
中 - zhōng - middle, center, China
中国 - Zhōngguó - China
中间 - zhōngjiān - middle, center
中文 - Zhōngwén - Chinese language
中午 - zhōngwǔ - noon, midday
中学 - zhōngxué - middle school, secondary school
中学生 - zhōngxuéshēng - middle school student
重 - zhòng - heavy, important
重要 - zhòngyào - important, significant
住 - zhù - live, stay
准备 - zhǔnbèi - prepare, ready
桌子 - zhuōzi - table, desk
字 - zì - character, word
子 - zǐ - child, son
走 - zǒu - walk, go
走路 - zǒulù - walk, go on foot
最 - zuì - most, -est (superlative)
最好 - zuìhǎo - best, had better
最后 - zuìhòu - last, finally
昨天 - zuótiān - yesterday
左 - zuǒ - left
左边 - zuǒbian - left side
坐 - zuò - sit
坐下 - zuòxià - sit down
做 - zuò - do, make
